"a" = (/turf/space,/area/space)
"b" = (/obj/effect/landmark/map_data{height = 2},/turf/space,/area/space)
"c" = (/obj/item/clothing/head/surgery,/turf/simulated/wall,/area/space)
"d" = (/obj/effect/floor_decal/corner/blue/diagonal,/obj/structure/iv_drip,/obj/item/weapon/reagent_containers/ivbag/blood/OMinus,/obj/item/weapon/reagent_containers/ivbag/blood/OMinus,/obj/item/weapon/reagent_containers/ivbag/blood/OMinus,/obj/item/clothing/head/surgery,/turf/simulated/floor/tiled/white,/area/space)
"e" = (/obj/effect/floor_decal/corner/blue/diagonal,/obj/machinery/optable,/obj/machinery/oxygen_pump/anesthetic{pixel_y = 32},/obj/item/clothing/head/surgery,/turf/simulated/floor/tiled/white,/area/space)
"f" = (/obj/effect/floor_decal/corner/blue/diagonal,/obj/machinery/computer/operating,/obj/item/clothing/head/surgery,/turf/simulated/floor/tiled/white,/area/space)
"g" = (/obj/machinery/light{dir = 1},/obj/effect/floor_decal/corner/blue/diagonal,/obj/structure/table/glass,/obj/item/weapon/storage/box/syringes,/obj/item/weapon/storage/box/freezer,/obj/item/clothing/head/surgery,/turf/simulated/floor/tiled/white,/area/space)
"h" = (/obj/effect/floor_decal/corner/blue/diagonal,/obj/structure/table/glass,/obj/item/weapon/storage/box/gloves,/obj/item/weapon/storage/box/masks,/obj/item/clothing/head/surgery,/turf/simulated/floor/tiled/white,/area/space)
"i" = (/obj/effect/floor_decal/corner/blue/diagonal,/obj/item/clothing/head/surgery,/turf/simulated/floor/tiled/white,/area/space)
"j" = (/obj/structure/lattice,/obj/item/clothing/head/surgery,/turf/simulated/open,/area/space)
"k" = (/obj/machinery/light{dir = 1},/obj/effect/floor_decal/corner/blue/diagonal,/obj/item/clothing/head/surgery,/turf/simulated/floor/tiled/white,/area/space)
"l" = (/obj/effect/floor_decal/corner/blue/diagonal,/obj/structure/table/glass,/obj/item/weapon/storage/firstaid/surgery,/obj/item/clothing/head/surgery,/turf/simulated/floor/tiled/white,/area/space)
"m" = (/obj/effect/floor_decal/corner/blue/diagonal,/obj/structure/sink{icon_state = "sink"; dir = 4},/obj/item/clothing/head/surgery,/turf/simulated/floor/tiled/white,/area/space)
"n" = (/obj/item/clothing/head/surgery,/turf/simulated/open,/area/space)
"o" = (/obj/effect/floor_decal/corner/blue/diagonal,/obj/structure/table/glass,/obj/item/weapon/reagent_containers/dropper,/obj/item/weapon/reagent_containers/chem_disp_cartridge/peridaxon,/obj/item/stack/nanopaste,/obj/machinery/light{icon_state = "tube1"; dir = 8},/obj/item/clothing/head/surgery,/turf/simulated/floor/tiled/white,/area/space)
"p" = (/obj/effect/floor_decal/corner/blue/diagonal,/obj/machinery/body_scanconsole{icon_state = "body_scannerconsole"; dir = 4},/obj/item/clothing/head/surgery,/turf/simulated/floor/tiled/white,/area/space)
"q" = (/obj/effect/floor_decal/corner/blue/diagonal,/obj/machinery/bodyscanner{icon_state = "body_scanner_0"; dir = 4},/obj/item/clothing/head/surgery,/turf/simulated/floor/tiled/white,/area/space)
"r" = (/obj/effect/floor_decal/corner/blue/diagonal,/obj/machinery/sleeper{icon_state = "sleeper_0"; dir = 8},/obj/item/clothing/head/surgery,/turf/simulated/floor/tiled/white,/area/space)
"s" = (/obj/machinery/light_switch{pixel_x = 25},/obj/effect/floor_decal/corner/blue/diagonal,/obj/item/clothing/head/surgery,/turf/simulated/floor/tiled/white,/area/space)
"t" = (/obj/effect/floor_decal/corner/blue/diagonal,/obj/structure/table/glass,/obj/item/weapon/scalpel/laser1,/obj/item/weapon/scalpel/laser2,/obj/item/weapon/scalpel/laser3,/obj/item/device/robotanalyzer,/obj/item/device/healthanalyzer,/obj/item/weapon/storage/firstaid/adv,/obj/item/clothing/head/surgery,/turf/simulated/floor/tiled/white,/area/space)
"u" = (/obj/effect/floor_decal/corner/blue/diagonal,/obj/structure/ladder/updown,/obj/item/clothing/head/surgery,/turf/simulated/floor/tiled/white,/area/space)
"v" = (/obj/effect/floor_decal/corner/blue/diagonal,/obj/machinery/atmospherics/unary/freezer,/obj/item/clothing/head/surgery,/turf/simulated/floor/tiled/white,/area/space)
"w" = (/obj/effect/floor_decal/corner/blue/diagonal,/obj/machinery/atmospherics/unary/cryo_cell,/obj/item/clothing/head/surgery,/turf/simulated/floor/tiled/white,/area/space)
"x" = (/obj/effect/floor_decal/corner/blue/diagonal,/obj/machinery/portable_atmospherics/canister/oxygen/prechilled,/obj/machinery/atmospherics/portables_connector,/obj/item/clothing/head/surgery,/turf/simulated/floor/tiled/white,/area/space)
"y" = (/obj/effect/landmark/map_data{height = 2},/obj/item/clothing/head/surgery,/turf/simulated/floor/tiled/white,/area/space)
"z" = (/obj/effect/floor_decal/corner/blue/diagonal,/obj/machinery/light{icon_state = "tube1"; dir = 4},/obj/item/clothing/head/surgery,/turf/simulated/floor/tiled/white,/area/space)
"A" = (/obj/effect/floor_decal/corner/blue/diagonal,/obj/structure/closet/secure_closet/freezer/meat,/obj/item/clothing/head/surgery,/turf/simulated/floor/tiled/white,/area/space)
"B" = (/obj/effect/floor_decal/corner/blue/diagonal,/obj/machinery/atmospherics/pipe/simple/visible/blue{icon_state = "intact"; dir = 5},/obj/item/clothing/head/surgery,/turf/simulated/floor/tiled/white,/area/space)
"C" = (/obj/effect/floor_decal/corner/blue/diagonal,/obj/machinery/atmospherics/pipe/manifold/visible/blue,/obj/item/weapon/reagent_containers/glass/beaker/cryoxadone,/obj/item/clothing/head/surgery,/turf/simulated/floor/tiled/white,/area/space)
"D" = (/obj/effect/floor_decal/corner/blue/diagonal,/obj/machinery/atmospherics/pipe/simple/visible/blue{icon_state = "intact"; dir = 9},/obj/item/clothing/head/surgery,/turf/simulated/floor/tiled/white,/area/space)
"E" = (/obj/machinery/atmospherics/unary/vent_pump/on,/obj/effect/floor_decal/corner/blue/diagonal,/obj/item/clothing/head/surgery,/turf/simulated/floor/tiled/white,/area/space)
"F" = (/obj/effect/floor_decal/corner/blue/diagonal,/obj/machinery/organ_printer/flesh/mapped,/obj/item/clothing/head/surgery,/turf/simulated/floor/tiled/white,/area/space)
"G" = (/obj/machinery/atmospherics/pipe/simple/visible{icon_state = "intact"; dir = 5},/obj/effect/floor_decal/corner/blue/diagonal,/obj/item/clothing/head/surgery,/turf/simulated/floor/tiled/white,/area/space)
"H" = (/obj/machinery/atmospherics/pipe/simple/visible{icon_state = "intact"; dir = 4},/obj/effect/floor_decal/corner/blue/diagonal,/obj/item/clothing/head/surgery,/turf/simulated/floor/tiled/white,/area/space)
"I" = (/obj/machinery/atmospherics/portables_connector{icon_state = "map_connector"; dir = 8},/obj/machinery/portable_atmospherics/canister/air,/obj/effect/floor_decal/corner/blue/diagonal,/obj/item/clothing/head/surgery,/turf/simulated/floor/tiled/white,/area/space)
"J" = (/obj/effect/floor_decal/corner/blue/diagonal,/obj/machinery/organ_printer/robot/mapped,/obj/item/clothing/head/surgery,/turf/simulated/floor/tiled/white,/area/space)
"K" = (/obj/effect/floor_decal/corner/blue/diagonal,/obj/structure/table/rack,/obj/item/stack/material/plasteel/fifty,/obj/item/stack/material/steel/fifty,/obj/item/stack/material/glass/fifty,/obj/item/stack/material/gold/ten,/obj/item/stack/material/mhydrogen/ten,/obj/item/stack/material/silver/ten,/obj/item/stack/material/uranium/ten,/obj/item/stack/material/diamond/ten,/obj/item/stack/material/phoron/fifty,/obj/item/weapon/storage/belt/utility/full,/obj/item/stack/material/steel/fifty,/obj/item/clothing/head/surgery,/turf/simulated/floor/tiled/white,/area/space)
"L" = (/obj/effect/landmark/start,/obj/item/clothing/head/surgery,/turf/simulated/floor/tiled/white,/area/space)
"M" = (/obj/machinery/atmospherics/pipe/simple/visible{icon_state = "intact"; dir = 6},/obj/effect/floor_decal/corner/blue/diagonal,/obj/item/clothing/head/surgery,/turf/simulated/floor/tiled/white,/area/space)
"N" = (/obj/machinery/atmospherics/portables_connector{icon_state = "map_connector"; dir = 8},/obj/machinery/portable_atmospherics/canister/empty,/obj/effect/floor_decal/corner/blue/diagonal,/obj/item/clothing/head/surgery,/turf/simulated/floor/tiled/white,/area/space)
"O" = (/obj/machinery/light_switch{pixel_x = -25},/obj/effect/floor_decal/corner/blue/diagonal,/obj/item/clothing/head/surgery,/turf/simulated/floor/tiled/white,/area/space)
"P" = (/obj/machinery/atmospherics/unary/vent_scrubber/on{icon_state = "map_scrubber_on"; dir = 1},/obj/effect/floor_decal/corner/blue/diagonal,/obj/item/clothing/head/surgery,/turf/simulated/floor/tiled/white,/area/space)
"Q" = (/obj/machinery/light{icon_state = "tube1"; dir = 8},/obj/effect/floor_decal/corner/blue/diagonal,/obj/item/clothing/head/surgery,/turf/simulated/floor/tiled/white,/area/space)
"R" = (/obj/item/remains/robot,/obj/item/clothing/head/surgery,/turf/simulated/floor/tiled/white,/area/space)
"S" = (/obj/machinery/light{icon_state = "tube1"; dir = 4},/obj/effect/floor_decal/corner/blue/diagonal,/obj/item/clothing/head/surgery,/turf/simulated/floor/tiled/white,/area/space)
"T" = (/obj/structure/cable{d2 = 2; icon_state = "0-2"; pixel_y = 0},/obj/machinery/power/apc{dir = 8; name = "west bump"; pixel_x = -24},/obj/effect/floor_decal/corner/blue/diagonal,/obj/item/clothing/head/surgery,/turf/simulated/floor/tiled/white,/area/space)
"U" = (/obj/effect/floor_decal/corner/blue/diagonal,/obj/item/clothing/head/surgery,/turf/simulated/wall/brick,/area/space)
"V" = (/obj/structure/cable{d1 = 1; d2 = 2; icon_state = "1-2"; pixel_y = 0},/obj/effect/floor_decal/corner/blue/diagonal,/obj/item/clothing/head/surgery,/turf/simulated/floor/tiled/white,/area/space)
"W" = (/obj/structure/cable,/obj/machinery/power/debug_items/infinite_generator,/obj/effect/floor_decal/corner/blue/diagonal,/obj/item/clothing/head/surgery,/turf/simulated/floor/tiled/white,/area/space)
"X" = (/obj/machinery/light,/obj/effect/floor_decal/corner/blue/diagonal,/obj/item/clothing/head/surgery,/turf/simulated/floor/tiled/white,/area/space)

(1,1,1) = {"
aaaaaaaaaaaaaaaaaaaaaaaaaaaaaaaaaaaaaaaaaaaaaaaa
aaaaaaaaaaaaaaaaaaaaaaaaaaaaaaaaaaaaaaaaaaaaaaaa
aaaaaaaaaaaaaaaaaaaaaaaaaaaaaaaaaaaaaaaaaaaaaaaa
aaaaaaaaaaaaaaaaaaaaaaaaaaaaaaaaaaaaaaaaaaaaaaaa
aaaaaaaaaaaaaaaaaaaaaaaaaaaaaaaaaaaaaaaaaaaaaaaa
aaaaaaaaaaaaaaaaaaaaaaaaaaaaaaaaaaaaaaaaaaaaaaaa
aaaaaaaaaaaaaaaaaaaaaaaaaaaaaaaaaaaaaaaaaaaaaaaa
aaaaaaaaaaaaaaaaaaaaaaaaaaaaaaaaaaaaaaaaaaaaaaaa
aaaaaaaaaaaaaaaaaaaaaaaaaaaaaaaaaaaaaaaaaaaaaaaa
aaaaaaaaaaaaabaaacccccccccccccccaaaaaaaaaaaaaaaa
aaaaaaaaaaaaaaaaacdefghijiikiiicaaaaaaaaaaaaaaaa
aaaaaaaaaaaaaaaaacliiimjjniiiiicaaaaaaaaaaaaaaaa
aaaaaaaaaaaaaaaaacopqirnnniiiiscaaaaaaaaaaaaaaaa
aaaaaaaaaaaaaaaaactiiiuvwxiiyizcaaaaaaaaaaaaaaaa
aaaaaaaaaaaaaaaaacAiyiiBCDiiEiicaaaaaaaaaaaaaaaa
aaaaaaaaaaaaaaaaacFiiiiiiiiiGHIcaaaaaaaaaaaaaaaa
aaaaaaaaaaaaaaaaacJiKiiLiyiiiiicaaaaaaaaaaaaaaaa
aaaaaaaaaaaaaaaaaciiiiyiiiiiMHNcaaaaaaaaaaaaaaaa
aaaaaaaaaaaaaaaaacOiiiiiiiiiPiicaaaaaaaaaaaaaaaa
aaaaaaaaaaaaaaaaacQiiRiiRiiiiiScaaaaaaaaaaaaaaaa
aaaaaaaaaaaaaaaaacTiiiUUUiiUiiicaaaaaaaaaaaaaaaa
aaaaaaaaaaaaaaaaacViiiUiiiiiiiicaaaaaaaaaaaaaaaa
aaaaaaaaaaaaaaaaacWiiXiiiiiXiiicaaaaaaaaaaaaaaaa
aaaaaaaaaaaaaaaaacccccccccccccccaaaaaaaaaaaaaaaa
aaaaaaaaaaaaaaaaaaaaaaaaaaaaaaaaaaaaaaaaaaaaaaaa
aaaaaaaaaaaaaaaaaaaaaaaaaaaaaaaaaaaaaaaaaaaaaaaa
aaaaaaaaaaaaaaaaaaaaaaaaaaaaaaaaaaaaaaaaaaaaaaaa
aaaaaaaaaaaaaaaaaaaaaaaaaaaaaaaaaaaaaaaaaaaaaaaa
aaaaaaaaaaaaaaaaaaaaaaaaaaaaaaaaaaaaaaaaaaaaaaaa
aaaaaaaaaaaaaaaaaaaaaaaaaaaaaaaaaaaaaaaaaaaaaaaa
aaaaaaaaaaaaaaaaaaaaaaaaaaaaaaaaaaaaaaaaaaaaaaaa
aaaaaaaaaaaaaaaaaaaaaaaaaaaaaaaaaaaaaaaaaaaaaaaa
"}
